11111111111111
1NC10000000C01
10000111110N01
1P0011EC000001
11111111111111
