11111
1NC11
10001
1P0E1
11111
