11111111111111
1NNNNNNNNNNNN1
1NNN111111NNN1
1PNN1NECNNNNN1
11111111111111
