11111110000001111111
10000010000001000001
100P001111111100E001
1000000C0CC0C0000001
10000011111111000001
10000010000001000001
11111110000001111111
