11111111111111
11P000C0000E11
11111111111111
11111N111NN111
1111NN11N11N11
111N1N1111N111
11NNNNN11N1111
11111N11NNNN11
11111111111111
11111111111111
