111111111111
1P11C11E11N1
111111111111
111111111111
101111111111
111111111111
