11111111111111
11111111111111
11P11C11E11N11
11111111111111
11111111111111
11P00C00E00N11
11111111111111
11111111111111
