11111111111111111
11111111111111111
11P11G11C11E11N11
11111111111111111
11111111111111111
11P00G00C00E00N11
11111111111111111
11111111111111111
