111111
1P0111
100111
1C01E1
111111
