000111110
00P100010
0C0100010
00C111110
0000000E0
000000000
