1111
1PC1
1001
1001
1001
1001
1001
1001
1001
1101
1E11
1111
