1111
1P011
100011
1CE0C1
111111
