1111111111111111111111111111
1NC10000000C011NC10000000C01
10000111110N0110000111110N01
1P0011EC0000011P0011EC000001
1111111111111111111111111111
