111111
1P00C1
100011
1CE11
1011
1111
