1111111111
1C11P000E1
1C11000001
1111111111
