1111111111111111
1P000000N0000CE1
1111111111111111
