1111111111111111111111
1P0011C0111000000010E1
1100110000001101101001
1001000111110001100001
100001111C00010010C001
1111111111111111111111
